########################################
#                                      #
###########                            #
#                                      #
#                                      #
#                                      #
#                                      #
#                                      #
#                        ###############
#                        #             #
#                        #             #
#                        #             #
#                        #             #
#                        #             #
#                        #             #
#                                      #
#                                      #
#################                      #
#                                      #
########################################